0 0 0 0 0 0 0 0 0 0 0 0 0 0 0 0 0 0 0 0
0 0 0 0 0 0 0 0 0 0 0 0 0 0 0 0 0 0 5 5
0 0 0 0 8 0 0 0 0 0 0 0 0 0 0 0 0 0 0 0
0 0 0 0 0 0 0 0 0 0 0 0 0 0 0 0 0 0 0 0
0 0 0 5 5 5 0 0 0 0 0 0 0 0 0 0 0 0 0 0
0 0 5 0 0 0 0 0 0 0 0 8 0 0 0 3 3 0 0 0
0 0 0 0 3 0 0 9 0 0 3 0 0 0 0 0 0 0 0 0
5 0 0 0 0 0 0 0 0 1 1 1 1 0 0 9 0 0 0 7
0 0 1 1 1 1 0 0 0 2 2 2 2 6 6 6 6 6 1 1
1 1 2 2 2 2 4 4 4 2 2 2 2 0 0 0 0 0 2 2
2 2 2 2 2 2 2 2 2 2 2 2 2 2 0 0 0 0 2 2
2 2 2 2 2 2 2 2 2 2 2 2 2 2 2 0 0 0 2 2